11111111111111111111111111111111111111111111111111
10000000000000000000000000000000000000000000000001
10000000000000000000000000000000000000000000000001
10000000000000000000000000000000000000000000000001
10000000000000000000000000000000000000000000000001
10000000000000000000000000000000000000000000000001
10000000000000000000000000000000000000000000000301
10000000000000000000000000000000000000000000000301
10000000000000000000000000000000000011111111111111
10000000000000000011111110000000000000000000000001
10000000000011000011111110000011110000000000000001
10000000000011222211111110000000000000000000000001
10000001111111111111111110000000000000000000000001
10000000000000000000000000000000000000000000000001
10000000000000000000000000000000000000000000000001
11111000000000000000000000000000000000000000000001
10000000000000000000000000000000000000000000000001
10000001110000000000000000000000000000000000000001
10000000000000000000000000000000000000000000000001
10000000000011100000000000000000000000000000000001
10000000000000000000000000000000000000110000000001
12222222222222221111000000000000012222110000000001
11111111111111111111111100001111111111111111100001
10000000000000000000000000000000000000000000000001
10000000000000000000000000000000000000000000000001
10000000000000000000000000000000000000000000000111
10000000000000000000000000000000000000000000001111
10000000000000000000000000000000000000000000001111
10000000000000000000000000000000000000111000001111
10000000000000000000000000000000000000000021111111
10000000000000000000000000000000001110000211111111
10000000000000000111111100000000000000002111111111
10000000000000000000000000000111000000021111111111
10000000000111100000000000000000000000211111111111
10400111000000000000000000000000000002111111111111
11111111000000000000000000000000000021111111111111
11111111222222222222222222222222222211111111111111