11111111111111111111111111111111111111111111111111
10000000000000000000000000000000000000000000000001
10000000000000000000000000000000000000000000000001
10000000000000000000000000000000000000000000000001
10000000000000000000000000000000000000000000000001
10000000000000000000000000000000000000000000000001
10000000000000000000000000000000000000001100000301
10000000000000000000000000000000000000011110000301
10000000000000000000000000011111000111111111111111
10000000000000000000000000000000000000000000000301
10000000000011000011111110000000000000000000000001
10000000000111222211111110000000000000000000000001
10000000111111111111111110000000000000000000000001
10000000000000000000000000000000000000000000000001
10000000000000000000000000000000000000000000000001
11111110000000000000000000000000000000000000000001
11111111000000000000000000000000000000000000000001
11111111100000000000000000000000000000000000000001
11111111110000000000000000000000000000000000000001
11111111111000000000000000000000000000000000000001
11111111111100000000000000000000010000110000000001
11111111111110000000000000000000112222111000000001
11111111111111110000111100001111111111111111100001
10000000000000000000000000000000000000000000000001
10000000000000000000000000000000000000000000000001
10000000000000000000000000000000000000000000000111
10000000000000000000000000000000000000000000001111
10000000000000000000000000000000000000000000001111
10000000000000000000000000000000000000111000001111
10000000000000000000000000000000000000000001111111
10000000000000000000000000000000001110000021111111
10000000000000000000000000000000000000000211111111
10000000000000000000000000000011100000002111111111
10000000000000000000000000000000000000021111111111
10400111000111111111110000111000000000211111111111
11111111000000000000000000000000000002111111111111
11111111000000000000000000000000000021111111111111
11111111222222222222222222222222222211111111111111