11111111111111111111111111111111111111111111111111
10000000000111001110000000000011100000011100000001
10000000000111001110000000000011100000011100000001
10000000000111001110000000000011100000011100000001
10000000000111001110000000000011100000011100000001
10000000000111001110000000000022200000011100000001
10000000000111001110000000000002000000011100000001
10000000000111001110000000000000000000011100000031
10000000000111001110000000000000000000011100000031
10000000000111001110000000000000000000011100000111
10000000000111001110000000000000000000011100000001
10000000000111001110000000000000000000011100000001
10000000000222001110000000000000000000022200000001
10000000000020001110000000020000000000002000000001
10000000000000001110000000222000000000000000000001
10000000000000001110000000111000000000000000000001
10000000000000001110000000111000000000000000000001
10000000000000001110000000111000000000000000000001
10000002000000001110000000111000000000000000000001
10000022200000001110000000111000000000000000000001
10000011100000001110000000111000000000000000000001
10000011100000001110000000111000000020000000000001
10000011100000001110000000111000000222000000000001
10000011100000002220000000111000000111000000000001
10000011100000000200000000111000000111000000000001
10000011100000000000000000111000000111000000000001
10040011100000000000000000111000000111000000000001
10000011100000000000000000111000000111000000000001
10000011100000000000000000111000000111000000000001
10000011100000000000000000111000000111000000000001
10000011100000000000000000111000000111000000000001
10000011100000000000000000111000000111000000000001
10111011100000000000000000111000000111000000000001
10111011100000000000000000111000000111000000000001
10111011100000000000000000111000000111000000000001
10111011100000000000000000111000000111000000000001
10111011100000000000000000111000000111000000000001
12111211122222222222222222111222222111222222222221