11111111111111111111111111111111111111111111111111
10000000000000000000000000000000000000000000000001
10400000000000000000000000000000000000000000000001
10000000000000000000000000000000000000000000000001
10000000000000000000000000000000000000000000000001
10000000000000000000000000000000000000000000000001
10000000000000000000000000000000000000000000000001
10000000000000000000000000000000000000000000000001
11111110000111111100001111111000011111111110000001
11111110000111111100001111111000011111111112220001
11111110000111111100001111111000011111111112220001
11111112222111111122221111111222211111111112220001
11111111111111111111111111111111111111111110000001
10000000000000000000000000000000000000000010000001
10000000000000000000000000000000000000000010000001
10000000000000000000000000000000000000000010000001
10000000000000000000000000000000000000000010000001
10000030000000000000000000000000000000000010000001
10000030000000000000000000000000000000000010002221
10001111110000000000000000000000000000000010002221
10001111110000000000000000000000000000000010002221
10001111110001100000000000000000000000000010000001
10001111110001100000000000000000000000000010000001
10001111110001110000000000000000000000000010000001
10001111110001110000000000000000000000000010000001
10001111110001111000000000000000000000000010000001
10001111110001111000000000000000000000000010000001
10001111110001111100000000000000000000000012220001
10001111110001111100000000000000000000000012220001
10001111110001111111000000000000000000000012220001
10001111110001111111000111000000000000000010000001
10001111110001111111000000000000000000000010000001
10001111110001111111000000011100000000000010000001
10001111110001111111000000000000000000000010000001
10001111110001111111000000000000111000000000000001
10001111110001111111000000000000000000000000000001
10001111110001111111000000000000000000000000000001
12221111112221111111222222222222221111111111111111