11111111111111111111111111111111111111111111111111
10000000000000000000000000000000000000000000000001
10400000000000000000000000000000000000000000000001
10000000000000000000000000000000000000000000000001
10000000000000000000000000000000000000000000000001
10000000000000000000000000000000000000000000000001
10000000000000000000000000000000000000000000000001
11110001111000010000000000000000000000000000000001
11112221111222211000000000000000000000000000000001
11111111111111111111111111111111111111111111110001
10000000000000000000000000000000000000000000010001
10000000000000000000000000000000000000000000010001
10000000000000000000000000000000000000000000010001
10000000000000000000000000000000000000000000000001
10000000000000000000000000000000000000000000000001
10000111111111100000000000000000000000000000000001
10000111111111111000011111100111110011111001111111
10000111111111111000000000000000000000000001111111
10000111111111111222222222222222222222222221111111
10000111111111111111111111111111111111111111111111
10000111111111111110000000000000000000000000000001
10000111111111111100000000000000000000000000000001
10000111111111111000000000000000000000000000000001
10000111111111110000000000000000000000000000000001
10000111111111100000000000000000000001110010000001
10000111111111000000000000000000000000000010000001
10000111111110000000000000000000011100000010000001
10000111111100000000000000000000000000000010000001
10000111111000000000000000000111000000000010000001
10000111110000000000000000000000000000000010000001
10000111100000000000000001110000000000000010000001
10000111000000000000000000000000000000000010000001
10000110000000000000011100000000000000000010000001
10000100000000000000000000000000000000000010000001
10000000000000000011100000000000000000000010000001
10000000000000000000000000000000000000000010003001
10000000000001110000000000000000000000000010003001
11111111111111112222222222222222222222222211111111