11111111111111111111111111111111111111111111111111
10000002220001110000000000001110000000011100000001
10000000200001110000000000001110000000011100000001
10000000000001110000000000001110000000011100000001
10000000000002220000000000001110000000011100000001
10400000000000200000000000001110000000011100000001
10000000000000000000000000001110000000011100000001
10000000000000000000000000001110000000011100000001
10000000000000000000000000002220000000022200000001
10000000000000000000000000000200000000002000000001
11111000000000000000000000000000000000000000000001
11110000000000000000000000000000000000000000000031
11100000000000000000200000000000000000000000000031
11000000000000000002220000000000000000000000001111
10000000000020000001110000000000000000000000002111
10000000000222000001110000000000020000000000002011
10000000000111000001110000000000222000000000002001
10000000000111000001110000000000111000000000002001
10000200000111000001110000000000111000002000002001
10002220000111000001110000200000111000022200002001
10001110000111000001110002220000111000011100002001
10001110000111000001110001110000111000011100002001
10001110000111000001110001110000111000011100002001
10001110000111000001110001110000111000011100002001
10001110000111000001110001110000111000011100002001
10001110000111000001110001110000111000011100002001
10001110000111000001110001110000111000011100002001
10001110000111000001110001110000111000011100002001
10001110000111000001110001110000111000011100002001
10001110000111000001110001110000111000011100002001
10001110000111000001110001110000111000011100002001
10001110000111000001110001110000111000011100002001
10001110000111000001110001110000111000011100002001
10001110000111000001110001110000111000011100002001
10001110000111000001110001110000111000011100002001
10001110000111000001110001110000111000011100002001
10001110000111000001110001110000111000011100002001
12221112222111222221112221112222111222211122222221