11111111111111111111111111111111111111111111111111
11111111111111111111111111111111111111111111111111
11111111111111111111111111111111111111111111111111
11111111111111111111111111111111111111111111111111
11111111111111111111111111112000000000000000000001
11111111111111111111111111120000000000000000000001
11111111111111111111111111200000000000000000000001
12111111111111111111112222000000000000000000000301
10211111111111111111120000000000000000000000000301
10021111111111111111200000000000000000001111111111
10002111111111111112000000000000000000002000011111
10000211111112222220000000000000000000002000001111
10000021111120000000000000000000000000002000000111
10000002222200000000000000000000222220002000000011
10000000000000000000000000000002111110002000000001
10000000000000000000000000000021111110002000000001
10000000000000000000000000000211111110002000000001
10000000000000000000000000002111111110002000000001
10000000000000000000000222221111111110002000000001
10000000000000000000002111111111111110002000000001
10000000000000000000021111111111111110002000000001
10000000000000000000211111111111111110002000000001
10000000000000000002111111111111111110002000000001
10000000000000222221111111111111111110002000000001
10000000000002111111111111111111111110002000000001
10000000222221111111111111111111111110002000000001
10000002111111111111111111111111111110002000000001
10000021111111111111111111111111111110002000000001
10000211111111111111111111111111111110002000000001
10000111111111111111111111111111111110002000000001
10000111111111111111111111111111111110002000000001
10000111111111111111111111111111111110002000000001
10000111111111111111111111111111111110002000000001
10000111111111111111111111111111111110002000000001
10400111111111111111111111111111111110002000000001
10000111111111111111111111111111111110002000000001
10000111111111111111111111111111111110002000000001
11111111111111111111111111111111111112222222222221