11111111111111111111111111111111111111111111111111
10000000000000000000000000000000000000000000000001
10400000000000000000000000000000000000000000000001
10000000000000000000000000000000000000000000000001
10000000000000000000000000000000000005000000000001
10000000000000000000000000000000000000000000000001
10000000000000000000000000000000000000000000000001
11110001111000010000000100001000111000000000000001
11112221111222211000000122221222222222210000000001
11111111111111111111111111111111111111111111110001
10000000000000000000000000000000000000000000010001
10000000000000000000000000000000000000000000010001
10000000000000000000000000000000000000000000010001
10000000000000000000000000500000000000000000000001
10000000000000000000000000000000000000000000000001
10000111100111100000000000000000000000000000000001
10000111100111111000011110000111000011100001111111
10000111100111111000000000000000000000000001111111
10000111122111111222222222222222222222222221111111
10000111111111111111111111111111111111111111111111
10000111111111111110000000000000000000000000000001
10000111111111111100000000000000000000000000000001
10000111111111111000000000000000000000000000000001
10000111111111110000000000000000000000000000000001
10000111111111100000000000000000000000110010000001
10000111111111000000000000000000000000000010000001
10000111111110000000000000050000001100000010000001
10000111111100000000000000000000000000000010000001
10000111111000000000000000000011000000000010000001
10000111110000000000000000000000000000000010000001
10000111100000000000000000110000000000000010000001
10000111000000000000000000000000000000000010000001
10000110000000000000001100000000000000000010000001
10000100000000000000000000000000000000000010000001
10000000000000000001100000000000000000000010000001
10000000000000000000000000000000000000000010003001
10000000000001110000000000000000000000000010003001
11111111111111112222222222222222222222222211111111