11111111111111111111111111111111111111111111111111
10000000000000011100000000000000000011100001110001
10000000000000011100000000000000000011100001110001
10000000000000011100000000000000000011100001110001
10000000000000011100000000000000000011100001110001
10000000000000011100000000000000000011100001110001
10000000000000011100000000000000000011100002220001
10000000000000011100000000000000000011100000200001
10400000000000011100000000000000000011100000000001
10000000000000011100000000000000000011100000000001
10000000000000011100000000020000000011100000000001
10000000000000011100000000222000000011100000000001
10000000000000011100000002222200000011100000000001
11110000000000011100000001111100000011100000000001
11100000000000011100000001111100000011100000000031
11000000000000022200000001111100000011100000000031
10000000000000002000000001111100000011100000011111
10000000200000000000000001111100000011100000001111
10000002220000000000000001111100000011100000000111
10000001110000000000000001111100000011100000000011
10000001110000000000000001111100000011100000000001
10000001110000000050000001111100000011100000000001
10000001110000000000000001111100000011100000000001
10000001110000000000000001111100000011100000000001
10000001110000000000200001111100000022200000000001
10000001110000000002220001111100000002000000000001
10000001110000000001110001111100000000000000000001
10000001110000000001110001111100000000000000000001
10000001110000000001110001111100000000000000000001
10000001110000000001110001111100000000000000000001
10000001110000000001110001111100000005000000000001
10000001110000000001110001111100000000000000000001
10000001110000000001110001111100000000000000000001
10000001110000000001110001111100000000000000000001
10000001110000000001110001111100000002000000000001
10000001110000000001110001111100000022200000000001
10000001110000000001110001111100000011100000000001
12222221112222222221112221111122222211122222222221