11111111111111111111111111111111111111111111111111
10000000000000000000000000000000000000000000000001
10000000000000000000000000000000000000000000000001
10000000000000000000000000000000000000000000000001
10000000000000000000000005000000000000000000000001
10000000000000000000000000000000000000000000000001
10000000000000000000000000000000000000001100000301
10000000000000000000000000000000000000011110000301
10000000000000000000000000011110000110011110001111
10000000000000000000000000000000000000000000001111
10000000000011000011100110022222222222222222221111
10000000000111222211122112211111111111111111111111
10000000111111111111111111110000000000000000000001
10000000000000000000000000000000000000000000000001
10000000000000000000000000000000000000000000000001
10011110000000000000000000000000000000000000000001
10011111000000000000000000500000000000000000000001
10011111100000000000000000000000000000000000000001
10011111100000000000000000000000000000000000000001
10011111101000000000000000000000000000000000000001
10011111101100000000000000000001110000110000000001
12211111121110000000000000000001112222111000000001
11111111111111110000111100000001111111111001100001
10000000000000000000000000000000000000000000000001
10000000000000000000000000000000000000000000000001
10000000000000000000000000000000000000000000000111
10000000000000000000000000000005000000000000001111
10000000000000000000000000000000000000000000000111
10000000000000000000000000000000000000110000000111
10000000000000000000000000000000000000000001100111
10400000000000000000000000000000001100000021100111
10000000000000000000000000000000000000000211100111
10000000000000000000000000000011000000002111100111
10000000000000000000000000000000000000021111100111
10000111000011100001110000111000000000211111100111
11111111000000000000000000000000000002111111100111
11111111000000000000000000000000000021111111100111
11111111222222222222222222222222222211111111122111