11111111111111111111111111111111111111111111111111
10000000000000011100000000000000000011100000000001
10000000000000011100000000000000000011100000000001
10000000000000011100000000000000000011100000000001
10000000000000011100000000000000000011100000000001
10000000000000011100000000000000000011100000000001
10000000000000011100000000000000000011100000000001
10000000000000011100000000000000000011100000000001
10400000000000011100000000000000000011100000000001
10000000000000011100000000000000000011100000000001
10000000000000011100000000000000000011100000000001
10000000000000011100000000002000000011100000000001
10000000000000011100000000022200000011100000000001
11110000000000011100000000011100000011100000000001
11100000000000022200000000011100000011100000000031
11000000000000002000000000011100000011100000000031
10000000000000000000000000011100000011100000011111
10000000000000000000000000011100000011100000001111
10000000000000000000000000011100000011100000000111
10000000200000000000000000011100000011100000000011
10000002220000000000000000011100000011100000000001
10000001110000000000000000011100000011100000000001
10000001110000000000000000011100000011100000000001
10000001110000000000000000011100000011100000000001
10000001110000000000200000011100000022200000000001
10000001110000000002220000011100000002000000000001
10000001110000000001110000011100000000000000000001
10000001110000000001110000011100000000000000000001
10000001110000000001110000011100000000000000000001
10000001110000000001110000011100000000000000000001
10000001110000000001110000011100000000000000000001
10000001110000000001110000011100000000000000000001
10000001110000000001110000011100000000000000000001
10000001110000000001110000011100000000000000000001
10000001110000000001110000011100000000000000000001
10000001110000000001110000011100000000000000000001
10000001110000000001110000011100000000000000000001
12222221112222222221112222211122222222222222222221