11111111111111111111111111111111111111111111111111
10000000000001110000000000001110000000011100000001
10000000000001110000000000001110000000011100000001
10000000000001110000000000001110000000011100000001
10000000000002220000000000001110000000011100000001
10400000000000200000000000001110000000011100000001
10000000000000000000000000001110000000022200000001
10000000000000000000000000002220000000002000000001
10000000000000000000000000000200000000000000000001
10000000000000000000000000000000000000000000000001
11111000000000000000000000000000000000000000000001
11110000000000000000000000000000000000000000000031
11100000000000000000000000000000000000000000000031
11000000000000000000000000000000000000000000001111
10000000000020000000000000000000000000000000000111
10000000000222000000200000000000000000000000000011
10000000000111000002220000000000000000000000000001
10000000000111000001110000000000020000000000000001
10000200000111000001110000000000222000002000000001
10002220000111000001110000000000111000022200000001
10001110000111000001110000000000111000011100000001
10001110000111000001110000200000111000011100000001
10001110000111000001110002220000111000011100000001
10001110000111000001110001110000111000011100000001
10001110000111000001110001110000111000011100000001
10001110000111000001110001110000111000011100000001
10001110000111000001110001110000111000011100000001
10001110000111000001110001110000111000011100000001
10001110000111000001110001110000111000011100000001
10001110000111000001110001110000111000011100000001
10001110000111000001110001110000111000011100000001
10001110000111000001110001110000111000011100000001
10001110000111000001110001110000111000011100000001
10001110000111000001110001110000111000011100000001
10001110000111000001110001110000111000011100000001
10001110000111000001110001110000111000011100000001
10001110000111000001110001110000111000011100000001
12221112222111222221112221112222111222211122222221