11111111111111111111111111111111111111111111111111
10000000000000000000000000000000000000000000000001
10400000000000005000000000000000000000000000000001
10000000000000000000000000000000000000000000000001
10000000000000000000000000000000000000000000000001
10000000000000000000000000000000000000000000000001
10000000000000100000000001000000000000000000000001
10000000000001110000000011100000000000000000000001
11111110000111111100001111111000011100011110000001
11111110000111111100001111111000011100011112200001
11111110000111111100001111111000011100011112200001
11111112222111111122221111111222211122211112200001
11111111111111111111111111111111111111111110000001
10000000000000000000000000000000000000000010000001
10000000000000000000000000000000000000000010000001
10000000000000000000000000000000000000000010000001
10000000000000000000000000000000000000000010000001
10000000000000000000000000000000000000000010000001
10000000000000000000000000000000000000000010000221
10000000000000000000000000000000000000000010000221
10000000000000000000000000000000000000000010000221
10003000000000000000000000000000000000000010000001
10003000000000000000000000000000000000000010000001
10001110000000000000000000000000000000000010050001
10001111100000000000050000000000000000000010000001
10001111100011000000000000000000000000000010000001
10001111100011000000000000000000000000000010000001
10001111100011011000000000000000000000000012200001
10001111100011011000000000000000000000000012200001
10001111100011011011000000000000000000000012200001
10001111100011011011000110000000000000000010000001
10001111100011011011000000000000000000000010000001
10001111100011011011000000011100000000000010000001
10001111100011011011000000000000000000000010000001
10001111100011011011000000000000011000000000000001
10001111100011011011000000000000000000000000000001
10001111100011011011000000000000000000000000000001
12221111122211211211222222222222221111111111111111